N  ./textures/jaimepas.xpm
EA ./textures/east.xpm
SO ./textures/south.xpm
W  ./textures/west.xpm
F 180,  130,  92
C 200,   140,     255


    1111111111111111111111111
    1000000000110000000000001
    1011000001110000000000001
    1001000000000000000000001
11111111101100000111000000001
10000000001100000111011111111
11110111111111011100000000001
11110111111111011101010010001
11000000110101011100000010001
10000000000000001100000010001
10000000000000000001010010001
11000001110101011111011110N0111
11110111 1110101 101111010001
11111111 1111111 111111111111
