
F 150,  150,   0
N                  ./textures/north.xpm
EA     ./textures/east.xpm 

C 255,   255,     255      222


SO ./textures/south.xpm

W        ./textures/west.xpm


11111111111
111111111111
1000000000001
1000000000001
10000000000001
1000000000001
10000000000001
100000E000001
10000000000001
1000000000001
10000000000001
1000000000001
1000000000001
111111111111