
F 150,  150,   0
N                  ./textures/north.xpm
EA     ./textures/east.xpm 

C 255,   255,     255      222


SO ./textures/south.xpm

W        ./textures/west.xpm


1111111
1000001
10000001
100W001
10000001
1000001
1111111
