
F 150,  150,   0
N                  ./textures/north.xpm
EA     ./textures/east.xpm 

C 255,   255,     255      222


SO ./textures/south.xpm

W        ./textures/west.xpm


11111
100001
10001
1N0001
10001
100001
11111
