NO                   ../textures/north.xpm

EA     ../textures/east.xpm

W        ../textures/west.xpm

SO ../textures/south.xpm

F 255,0,0
C 125,165,255


    1111111111111
1000000000001
1000000000001
1000000000001
1000000000001
1000000000001
1111111111111