
F 150,  150,   0
N                  ./textures/north.xpm
EA     ./textures/east.xpm 

C 255,   255,     255      222


SO ./textures/south.xpm

W        ./textures/west.xpm

111111111111
100000000001
10000W0000001
100000000001
11111111111