NO                   ../textures/north.xpm
SO ../textures/south.xpm
W        ../textures/west.xpm
EA     ../textures/east.xpm


F 255,0,0
C 0,165,255


1111111111111
1000000000001
1000000000001
1000000000001
1000000000001
1000000000001
1111111111111