NO                  ./textures/north.xpm

EA     ./textures/east.xpm

W        ./textures/west.xpm

SO ./textures/south.xpm

F 255,0,
C 125,165,250


1111111111111
1000000110001
1000101  10001
1001 101100011
10001010100001
1000000000001
1111111111111